1111111111111111
1P00C00000000001
1000000000000001
1000000000C000C1
1000000B00000001
100000000000CC01
1000000000000001
10000000000000E1
1111111111111111
