1111111111111111
1P00C00000000001
1C00100000000001
100C100000C000C1
1000100B00000001
100010000000CC01
1000100100000001
10000C00000000E1
1111111111111111
