1111111111111
10010000000C1
1001111111111
1P0000E000001
1111111111111
