1111111111111
1001000000001
1000B11111001
1PP011G000001
1111111111111
