111111111111111
100000PCE000001
111111111111111
111111111111111
111111111111111

111111111111111
111111111111111
