111111111111111
100000BE00CP001
111111111111111
